333333333333
333333333333
111111111111
1P00000000W1
111111111111
111111111111