111111111111
100000001001
1000P0001001
100100100001
1E1C01000001
111111111111